         ##           
         ##           
         ##      #####
#####    ##      #####
   XX    ##      ##O##
   XX    ##      #####
   XX    ##           
@  XX                 
#####XXXXXXXXXXX######