   #     ##            
   #     ##            
   #     ##     #######
#####    ##     ##   ##
   ##    ##     ## O ##
   ##    ##     #######
   ##    ##            
@  ##
#####XXXXXXXXXXX#######